Ensayo, Estimulo, Respuesta, Correcto, Aciertos, Errores, Hits, ContadorH, Rechazos, ContadorR, Falsas alarmas, ContadorF, Omisiones, ContadorM, 
0,10,n,False,0,1,False,0,False,0,False,0,True,1,
1,38,s,True,1,1,True,1,False,0,False,0,False,1,
2,7,s,True,2,1,True,2,False,0,False,0,False,1,
3,13,n,False,2,2,False,2,False,0,False,0,True,2,
4,19,n,True,3,2,False,2,True,1,False,0,False,2,
5,23,n,True,4,2,False,2,True,2,False,0,False,2,
6,40,s,True,5,2,True,3,False,2,False,0,False,2,
7,32,s,True,6,2,True,4,False,2,False,0,False,2,
8,4,n,True,7,2,False,4,True,3,False,0,False,2,
9,44,n,True,8,2,False,4,True,4,False,0,False,2,
10,15,s,True,9,2,True,5,False,4,False,0,False,2,
11,21,n,True,10,2,False,5,True,5,False,0,False,2,
12,8,s,True,11,2,True,6,False,5,False,0,False,2,
13,47,n,True,12,2,False,6,True,6,False,0,False,2,
14,36,s,True,13,2,True,7,False,6,False,0,False,2,
15,31,s,True,14,2,True,8,False,6,False,0,False,2,
16,25,n,True,15,2,False,8,True,7,False,0,False,2,
17,46,s,False,15,3,False,8,False,7,True,1,False,2,
18,28,n,True,16,3,False,8,True,8,False,1,False,2,
19,5,n,True,17,3,False,8,True,9,False,1,False,2,
20,3,n,True,18,3,False,8,True,10,False,1,False,2,
21,42,n,True,19,3,False,8,True,11,False,1,False,2,
22,39,s,True,20,3,True,9,False,11,False,1,False,2,
23,35,s,True,21,3,True,10,False,11,False,1,False,2,
24,2,n,True,22,3,False,10,True,12,False,1,False,2,
25,41,n,False,22,4,False,10,False,12,False,1,True,3,
26,45,s,False,22,5,False,10,False,12,True,2,False,3,
27,33,n,False,22,6,False,10,False,12,False,2,True,4,
28,48,s,False,22,7,False,10,False,12,True,3,False,4,
29,24,s,False,22,8,False,10,False,12,True,4,False,4,
30,1,n,True,23,8,False,10,True,13,False,4,False,4,
31,11,s,True,24,8,True,11,False,13,False,4,False,4,
32,26,n,True,25,8,False,11,True,14,False,4,False,4,
33,27,n,True,26,8,False,11,True,15,False,4,False,4,
34,9,n,False,26,9,False,11,False,15,False,4,True,5,
35,37,s,True,27,9,True,12,False,15,False,4,False,5,
36,29,n,True,28,9,False,12,True,16,False,4,False,5,
37,22,s,False,28,10,False,12,False,16,True,5,False,5,
38,6,n,False,28,11,False,12,False,16,False,5,True,6,
39,34,s,True,29,11,True,13,False,16,False,5,False,6,
40,18,n,False,29,12,False,13,False,16,False,5,True,7,
41,16,s,True,30,12,True,14,False,16,False,5,False,7,
42,17,n,False,30,13,False,14,False,16,False,5,True,8,
43,30,n,True,31,13,False,14,True,17,False,5,False,8,
44,43,s,False,31,14,False,14,False,17,True,6,False,8,
45,12,s,True,32,14,True,15,False,17,False,6,False,8,
46,14,n,False,32,15,False,15,False,17,False,6,True,9,
47,20,s,False,32,16,False,15,False,17,True,7,False,9,
0,23,n,True,33,16,False,15,True,18,False,7,False,9,
1,31,s,True,34,16,True,16,False,18,False,7,False,9,
2,30,n,True,35,16,False,16,True,19,False,7,False,9,
3,29,n,True,36,16,False,16,True,20,False,7,False,9,
4,1,n,True,37,16,False,16,True,21,False,7,False,9,
5,20,s,False,37,17,False,16,False,21,True,8,False,9,
6,19,n,True,38,17,False,16,True,22,False,8,False,9,
7,48,s,False,38,18,False,16,False,22,True,9,False,9,
8,28,n,True,39,18,False,16,True,23,False,9,False,9,
9,27,n,True,40,18,False,16,True,24,False,9,False,9,
10,43,n,True,41,18,False,16,True,25,False,9,False,9,
11,2,n,True,42,18,False,16,True,26,False,9,False,9,
12,45,s,False,42,19,False,16,False,26,True,10,False,9,
13,5,n,True,43,19,False,16,True,27,False,10,False,9,
14,46,n,True,44,19,False,16,True,28,False,10,False,9,
15,34,s,True,45,19,True,17,False,28,False,10,False,9,
16,24,s,False,45,20,False,17,False,28,True,11,False,9,
17,21,n,True,46,20,False,17,True,29,False,11,False,9,
18,41,s,True,47,20,True,18,False,29,False,11,False,9,
19,9,n,False,47,21,False,18,False,29,False,11,True,10,
20,33,n,False,47,22,False,18,False,29,False,11,True,11,
21,44,s,False,47,23,False,18,False,29,True,12,False,11,
22,18,n,False,47,24,False,18,False,29,False,12,True,12,
23,12,s,True,48,24,True,19,False,29,False,12,False,12,
24,17,n,False,48,25,False,19,False,29,False,12,True,13,
25,22,s,False,48,26,False,19,False,29,True,13,False,13,
26,8,n,False,48,27,False,19,False,29,False,13,True,14,
27,36,s,True,49,27,True,20,False,29,False,13,False,14,
28,39,s,True,50,27,True,21,False,29,False,13,False,14,
29,14,n,False,50,28,False,21,False,29,False,13,True,15,
30,37,n,False,50,29,False,21,False,29,False,13,True,16,
31,42,n,True,51,29,False,21,True,30,False,13,False,16,
32,32,s,True,52,29,True,22,False,30,False,13,False,16,
33,4,n,True,53,29,False,22,True,31,False,13,False,16,
34,47,n,True,54,29,False,22,True,32,False,13,False,16,
35,35,s,True,55,29,True,23,False,32,False,13,False,16,
36,6,n,False,55,30,False,23,False,32,False,13,True,17,
37,15,s,True,56,30,True,24,False,32,False,13,False,17,
38,3,n,True,57,30,False,24,True,33,False,13,False,17,
39,40,s,True,58,30,True,25,False,33,False,13,False,17,
40,11,s,True,59,30,True,26,False,33,False,13,False,17,
41,10,n,False,59,31,False,26,False,33,False,13,True,18,
42,13,n,False,59,32,False,26,False,33,False,13,True,19,
43,7,s,True,60,32,True,27,False,33,False,13,False,19,
44,16,s,True,61,32,True,28,False,33,False,13,False,19,
45,38,s,True,62,32,True,29,False,33,False,13,False,19,
46,25,s,False,62,33,False,29,False,33,True,14,False,19,
47,26,n,True,63,33,False,29,True,34,False,14,False,19,
0,37,s,True,64,33,True,30,False,34,False,14,False,19,
1,9,n,False,64,34,False,30,False,34,False,14,True,20,
2,35,s,True,65,34,True,31,False,34,False,14,False,20,
3,11,s,True,66,34,True,32,False,34,False,14,False,20,
4,7,s,True,67,34,True,33,False,34,False,14,False,20,
5,22,s,False,67,35,False,33,False,34,True,15,False,20,
6,2,n,True,68,35,False,33,True,35,False,15,False,20,
7,38,s,True,69,35,True,34,False,35,False,15,False,20,
8,46,s,False,69,36,False,34,False,35,True,16,False,20,
9,27,n,True,70,36,False,34,True,36,False,16,False,20,
10,32,s,True,71,36,True,35,False,36,False,16,False,20,
11,26,n,True,72,36,False,35,True,37,False,16,False,20,
12,17,n,False,72,37,False,35,False,37,False,16,True,21,
13,5,n,True,73,37,False,35,True,38,False,16,False,21,
14,34,s,True,74,37,True,36,False,38,False,16,False,21,
15,12,s,True,75,37,True,37,False,38,False,16,False,21,
16,36,s,True,76,37,True,38,False,38,False,16,False,21,
17,31,s,True,77,37,True,39,False,38,False,16,False,21,
18,39,s,True,78,37,True,40,False,38,False,16,False,21,
19,3,n,True,79,37,False,40,True,39,False,16,False,21,
20,29,n,True,80,37,False,40,True,40,False,16,False,21,
21,14,n,False,80,38,False,40,False,40,False,16,True,22,
22,16,s,True,81,38,True,41,False,40,False,16,False,22,
23,45,n,True,82,38,False,41,True,41,False,16,False,22,
24,24,s,False,82,39,False,41,False,41,True,17,False,22,
25,42,s,False,82,40,False,41,False,41,True,18,False,22,
26,1,n,True,83,40,False,41,True,42,False,18,False,22,
27,25,n,True,84,40,False,41,True,43,False,18,False,22,
28,21,s,False,84,41,False,41,False,43,True,19,False,22,
29,18,n,False,84,42,False,41,False,43,False,19,True,23,
30,43,n,True,85,42,False,41,True,44,False,19,False,23,
31,28,n,True,86,42,False,41,True,45,False,19,False,23,
32,13,n,False,86,43,False,41,False,45,False,19,True,24,
33,20,s,False,86,44,False,41,False,45,True,20,False,24,
34,33,s,True,87,44,True,42,False,45,False,20,False,24,
35,19,n,True,88,44,False,42,True,46,False,20,False,24,
36,23,n,True,89,44,False,42,True,47,False,20,False,24,
37,6,n,False,89,45,False,42,False,47,False,20,True,25,
38,4,n,True,90,45,False,42,True,48,False,20,False,25,
39,41,n,False,90,46,False,42,False,48,False,20,True,26,
40,30,n,True,91,46,False,42,True,49,False,20,False,26,
41,47,n,True,92,46,False,42,True,50,False,20,False,26,
42,44,s,False,92,47,False,42,False,50,True,21,False,26,
43,10,n,False,92,48,False,42,False,50,False,21,True,27,
44,15,s,True,93,48,True,43,False,50,False,21,False,27,
45,40,s,True,94,48,True,44,False,50,False,21,False,27,
46,48,s,False,94,49,False,44,False,50,True,22,False,27,
47,8,s,True,95,49,True,45,False,50,False,22,False,27,
0,12,s,True,96,49,True,46,False,50,False,22,False,27,
1,21,n,True,97,49,False,46,True,51,False,22,False,27,
2,33,s,True,98,49,True,47,False,51,False,22,False,27,
3,25,n,True,99,49,False,47,True,52,False,22,False,27,
4,38,s,True,100,49,True,48,False,52,False,22,False,27,
5,19,n,True,101,49,False,48,True,53,False,22,False,27,
6,10,n,False,101,50,False,48,False,53,False,22,True,28,
7,14,n,False,101,51,False,48,False,53,False,22,True,29,
8,18,n,False,101,52,False,48,False,53,False,22,True,30,
9,37,s,True,102,52,True,49,False,53,False,22,False,30,
10,40,s,True,103,52,True,50,False,53,False,22,False,30,
11,1,n,True,104,52,False,50,True,54,False,22,False,30,
12,3,n,True,105,52,False,50,True,55,False,22,False,30,
13,13,s,True,106,52,True,51,False,55,False,22,False,30,
14,36,s,True,107,52,True,52,False,55,False,22,False,30,
15,27,n,True,108,52,False,52,True,56,False,22,False,30,
16,20,s,False,108,53,False,52,False,56,True,23,False,30,
17,7,s,True,109,53,True,53,False,56,False,23,False,30,
18,42,s,False,109,54,False,53,False,56,True,24,False,30,
19,8,s,True,110,54,True,54,False,56,False,24,False,30,
20,24,s,False,110,55,False,54,False,56,True,25,False,30,
21,32,s,True,111,55,True,55,False,56,False,25,False,30,
22,9,n,False,111,56,False,55,False,56,False,25,True,31,
23,26,n,True,112,56,False,55,True,57,False,25,False,31,
24,23,s,False,112,57,False,55,False,57,True,26,False,31,
25,43,n,True,113,57,False,55,True,58,False,26,False,31,
26,45,n,True,114,57,False,55,True,59,False,26,False,31,
27,4,n,True,115,57,False,55,True,60,False,26,False,31,
28,34,s,True,116,57,True,56,False,60,False,26,False,31,
29,48,s,False,116,58,False,56,False,60,True,27,False,31,
30,15,s,True,117,58,True,57,False,60,False,27,False,31,
31,44,n,True,118,58,False,57,True,61,False,27,False,31,
32,2,n,True,119,58,False,57,True,62,False,27,False,31,
33,6,n,False,119,59,False,57,False,62,False,27,True,32,
34,31,s,True,120,59,True,58,False,62,False,27,False,32,
35,35,s,True,121,59,True,59,False,62,False,27,False,32,
36,5,n,True,122,59,False,59,True,63,False,27,False,32,
37,28,n,True,123,59,False,59,True,64,False,27,False,32,
38,30,n,True,124,59,False,59,True,65,False,27,False,32,
39,11,s,True,125,59,True,60,False,65,False,27,False,32,
40,29,n,True,126,59,False,60,True,66,False,27,False,32,
41,22,s,False,126,60,False,60,False,66,True,28,False,32,
42,46,s,False,126,61,False,60,False,66,True,29,False,32,
43,41,s,True,127,61,True,61,False,66,False,29,False,32,
44,17,s,True,128,61,True,62,False,66,False,29,False,32,
45,39,s,True,129,61,True,63,False,66,False,29,False,32,
46,16,s,True,130,61,True,64,False,66,False,29,False,32,
47,47,n,True,131,61,False,64,True,67,False,29,False,32,
0,34,s,True,132,61,True,65,False,67,False,29,False,32,
1,16,s,True,133,61,True,66,False,67,False,29,False,32,
2,10,s,True,134,61,True,67,False,67,False,29,False,32,
3,26,n,True,135,61,False,67,True,68,False,29,False,32,
4,5,n,True,136,61,False,67,True,69,False,29,False,32,
5,38,s,True,137,61,True,68,False,69,False,29,False,32,
6,25,n,True,138,61,False,68,True,70,False,29,False,32,
7,39,s,True,139,61,True,69,False,70,False,29,False,32,
8,22,s,False,139,62,False,69,False,70,True,30,False,32,
9,8,s,True,140,62,True,70,False,70,False,30,False,32,
10,29,n,True,141,62,False,70,True,71,False,30,False,32,
11,14,n,False,141,63,False,70,False,71,False,30,True,33,
12,41,n,False,141,64,False,70,False,71,False,30,True,34,
13,12,s,True,142,64,True,71,False,71,False,30,False,34,
14,11,s,True,143,64,True,72,False,71,False,30,False,34,
15,20,s,False,143,65,False,72,False,71,True,31,False,34,
16,42,s,False,143,66,False,72,False,71,True,32,False,34,
17,24,s,False,143,67,False,72,False,71,True,33,False,34,
18,23,n,True,144,67,False,72,True,72,False,33,False,34,
19,46,n,True,145,67,False,72,True,73,False,33,False,34,
20,1,n,True,146,67,False,72,True,74,False,33,False,34,
21,19,n,True,147,67,False,72,True,75,False,33,False,34,
22,9,n,False,147,68,False,72,False,75,False,33,True,35,
23,47,s,False,147,69,False,72,False,75,True,34,False,35,
24,33,s,True,148,69,True,73,False,75,False,34,False,35,
25,7,s,True,149,69,True,74,False,75,False,34,False,35,
26,6,n,False,149,70,False,74,False,75,False,34,True,36,
27,2,n,True,150,70,False,74,True,76,False,34,False,36,
28,35,s,True,151,70,True,75,False,76,False,34,False,36,
29,28,n,True,152,70,False,75,True,77,False,34,False,36,
30,4,n,True,153,70,False,75,True,78,False,34,False,36,
31,40,s,True,154,70,True,76,False,78,False,34,False,36,
32,15,s,True,155,70,True,77,False,78,False,34,False,36,
33,44,s,False,155,71,False,77,False,78,True,35,False,36,
34,18,s,True,156,71,True,78,False,78,False,35,False,36,
35,43,n,True,157,71,False,78,True,79,False,35,False,36,
36,37,n,False,157,72,False,78,False,79,False,35,True,37,
37,36,s,True,158,72,True,79,False,79,False,35,False,37,
38,31,s,True,159,72,True,80,False,79,False,35,False,37,
39,30,n,True,160,72,False,80,True,80,False,35,False,37,
40,21,n,True,161,72,False,80,True,81,False,35,False,37,
41,32,s,True,162,72,True,81,False,81,False,35,False,37,
42,45,n,True,163,72,False,81,True,82,False,35,False,37,
43,3,n,True,164,72,False,81,True,83,False,35,False,37,
44,27,n,True,165,72,False,81,True,84,False,35,False,37,
45,17,s,True,166,72,True,82,False,84,False,35,False,37,
46,48,s,False,166,73,False,82,False,84,True,36,False,37,
47,13,s,True,167,73,True,83,False,84,False,36,False,37,
0,11,s,True,168,73,True,84,False,84,False,36,False,37,
1,21,n,True,169,73,False,84,True,85,False,36,False,37,
2,14,n,False,169,74,False,84,False,85,False,36,True,38,
3,8,s,True,170,74,True,85,False,85,False,36,False,38,
4,23,n,True,171,74,False,85,True,86,False,36,False,38,
5,46,s,False,171,75,False,85,False,86,True,37,False,38,
6,16,s,True,172,75,True,86,False,86,False,37,False,38,
7,30,n,True,173,75,False,86,True,87,False,37,False,38,
8,13,s,True,174,75,True,87,False,87,False,37,False,38,
9,20,s,False,174,76,False,87,False,87,True,38,False,38,
10,24,s,False,174,77,False,87,False,87,True,39,False,38,
11,32,s,True,175,77,True,88,False,87,False,39,False,38,
12,47,n,True,176,77,False,88,True,88,False,39,False,38,
13,15,s,True,177,77,True,89,False,88,False,39,False,38,
14,35,s,True,178,77,True,90,False,88,False,39,False,38,
15,3,n,True,179,77,False,90,True,89,False,39,False,38,
16,7,s,True,180,77,True,91,False,89,False,39,False,38,
17,43,n,True,181,77,False,91,True,90,False,39,False,38,
18,36,s,True,182,77,True,92,False,90,False,39,False,38,
19,44,s,False,182,78,False,92,False,90,True,40,False,38,
20,39,s,True,183,78,True,93,False,90,False,40,False,38,
21,29,s,False,183,79,False,93,False,90,True,41,False,38,
22,28,n,True,184,79,False,93,True,91,False,41,False,38,
23,17,s,True,185,79,True,94,False,91,False,41,False,38,
24,31,s,True,186,79,True,95,False,91,False,41,False,38,
25,41,n,False,186,80,False,95,False,91,False,41,True,39,
26,42,s,False,186,81,False,95,False,91,True,42,False,39,
27,10,n,False,186,82,False,95,False,91,False,42,True,40,
28,12,s,True,187,82,True,96,False,91,False,42,False,40,
29,45,s,False,187,83,False,96,False,91,True,43,False,40,
30,18,n,False,187,84,False,96,False,91,False,43,True,41,
31,1,n,True,188,84,False,96,True,92,False,43,False,41,
32,19,s,False,188,85,False,96,False,92,True,44,False,41,
33,38,n,False,188,86,False,96,False,92,False,44,True,42,
34,9,n,False,188,87,False,96,False,92,False,44,True,43,
35,2,n,True,189,87,False,96,True,93,False,44,False,43,
36,48,s,False,189,88,False,96,False,93,True,45,False,43,
37,27,n,True,190,88,False,96,True,94,False,45,False,43,
38,22,s,False,190,89,False,96,False,94,True,46,False,43,
39,25,s,False,190,90,False,96,False,94,True,47,False,43,
40,6,n,False,190,91,False,96,False,94,False,47,True,44,
41,26,n,True,191,91,False,96,True,95,False,47,False,44,
42,37,s,True,192,91,True,97,False,95,False,47,False,44,
43,4,n,True,193,91,False,97,True,96,False,47,False,44,
44,33,s,True,194,91,True,98,False,96,False,47,False,44,
45,5,s,False,194,92,False,98,False,96,True,48,False,44,
46,34,s,True,195,92,True,99,False,96,False,48,False,44,
47,40,s,True,196,92,True,100,False,96,False,48,False,44,
0,10,n,False,196,93,False,100,False,96,False,48,True,45,
1,30,n,True,197,93,False,100,True,97,False,48,False,45,
2,26,n,True,198,93,False,100,True,98,False,48,False,45,
3,16,s,True,199,93,True,101,False,98,False,48,False,45,
4,29,n,True,200,93,False,101,True,99,False,48,False,45,
5,41,n,False,200,94,False,101,False,99,False,48,True,46,
6,33,s,True,201,94,True,102,False,99,False,48,False,46,
7,15,s,True,202,94,True,103,False,99,False,48,False,46,
8,31,s,True,203,94,True,104,False,99,False,48,False,46,
9,40,s,True,204,94,True,105,False,99,False,48,False,46,
10,28,n,True,205,94,False,105,True,100,False,48,False,46,
11,14,n,False,205,95,False,105,False,100,False,48,True,47,
12,42,s,False,205,96,False,105,False,100,True,49,False,47,
13,8,s,True,206,96,True,106,False,100,False,49,False,47,
14,18,n,False,206,97,False,106,False,100,False,49,True,48,
15,25,n,True,207,97,False,106,True,101,False,49,False,48,
16,17,n,False,207,98,False,106,False,101,False,49,True,49,
17,7,s,True,208,98,True,107,False,101,False,49,False,49,
18,4,n,True,209,98,False,107,True,102,False,49,False,49,
19,22,s,False,209,99,False,107,False,102,True,50,False,49,
20,24,s,False,209,100,False,107,False,102,True,51,False,49,
21,48,s,False,209,101,False,107,False,102,True,52,False,49,
22,35,s,True,210,101,True,108,False,102,False,52,False,49,
23,1,n,True,211,101,False,108,True,103,False,52,False,49,
24,46,s,False,211,102,False,108,False,103,True,53,False,49,
25,20,s,False,211,103,False,108,False,103,True,54,False,49,
26,12,s,True,212,103,True,109,False,103,False,54,False,49,
27,3,n,True,213,103,False,109,True,104,False,54,False,49,
28,38,s,True,214,103,True,110,False,104,False,54,False,49,
29,45,s,False,214,104,False,110,False,104,True,55,False,49,
30,47,s,False,214,105,False,110,False,104,True,56,False,49,
31,32,s,True,215,105,True,111,False,104,False,56,False,49,
32,11,s,True,216,105,True,112,False,104,False,56,False,49,
33,19,n,True,217,105,False,112,True,105,False,56,False,49,
34,39,s,True,218,105,True,113,False,105,False,56,False,49,
35,21,n,True,219,105,False,113,True,106,False,56,False,49,
36,36,s,True,220,105,True,114,False,106,False,56,False,49,
37,13,n,False,220,106,False,114,False,106,False,56,True,50,
38,23,n,True,221,106,False,114,True,107,False,56,False,50,
39,2,n,True,222,106,False,114,True,108,False,56,False,50,
40,44,s,False,222,107,False,114,False,108,True,57,False,50,
41,6,n,False,222,108,False,114,False,108,False,57,True,51,
42,43,s,False,222,109,False,114,False,108,True,58,False,51,
43,34,s,True,223,109,True,115,False,108,False,58,False,51,
44,37,n,False,223,110,False,115,False,108,False,58,True,52,
45,5,n,True,224,110,False,115,True,109,False,58,False,52,
46,27,n,True,225,110,False,115,True,110,False,58,False,52,
47,9,n,False,225,111,False,115,False,110,False,58,True,53,
